ATS=CHELIN AUSTRIACO
AUD=DOLAR AUSTRALIANO
BEF=FRANCO BELGA
CAD=DOLAR CANADIENSE
CZK=CORONA CHEKA
CHF=FRANCO SUIZO
DEM=MARCO ALEMAN
DKK=CORONA DANESA
ESP=PESETAS ESPAÑOLA
EUR=EURO
FIM=MARCO FINLANDES
FRF=FRANCO FRANCES
GBP=LIBRA ESTERLINA
GRD=DRACMA GRIEGO
IEP=LIBRA IRLANDESA
ITL=LIRA ITALIANA
JPY=YEN JAPONES
MAD=DIRHAN MARROQUI
NLG=FLORIN HOLANDES
NOK=CORONA NORUEGA
NZD=DOLAR NEOZELANDES
PTE=ESCUDO PORTUGUES
SEK=CORONA SUECA
USD=DOLAR U.S.A.
XEU=ECU
BCR=CRUZEIRO BRASILEÑO
KWD=DINAR KUWAITI
LUF=FRANCO LUXEMBURGUES
MXP=PESO MEJICANO
PTA=PESETA
SAR=RIALS ARABIA SAUDITA
SGP=DOLAR SINGAPUR
VEB=BOLIVAR VENEZOLANO